ا	a	â
آ	A	â
ن	n	n
ڼ	ṇ	ṇ
ب	b	b
ت	t	t
ټ	ṭ	ṭ
ي	i	i
ی	y	y
ى	y	y
ې	e	e
ۍ	ÿ	ëy
ﺉ	Y	Y
ث	S	s
پ	p	p
ح	H	h
خ	x	x
ج	ǰ	ǰ
څ	c	c
چ	č	č
ځ	ż	ż
ر	r	r
ړ	ṛ	ṛ
ز	z	z
ږ	ǧ	ǧ
ژ	ž	ž
د	d	d
ډ	ḍ	ḍ
ذ	Z	z
س	s	s
ښ	x̌	x̌
ش	š	š
ص	Ś	s
ض	Ź	z
ط	T	t
ظ	Z̀	z
ع	‘
غ	ġ	ġ
ف	f	f
ق	q	q
ک	k	k
ك	k	k
ګ	g	g
ل	l	l
م	m	m
ه	h	h
ۀ	ə	ë
و	w	w
ء	`	
؟	?	?
،	,	,